 198 198 198 198 198 198 198 198 198 198 198 198 198 198 198 198 198 200 198 198 198 198 198 198 198 198 198 198 198 198 198 198
 198   0   0   0 198   0   0   0   0   0   0   0 198   0   0   0   0   0   0   0   0   0   0   0   0   0 198   0   0   0  90 198
 198  91 198   0   0   0 198 198 198 198 198   0 198  89 198   0 198 198 198 198 198   0 198 198 198 198 198   0 198 198 198 198
 198 198 198 198 198   0   0   0 198  93 198   0 198 198 198   0 198   0   0   0 198 198 198   0   0  97 198   0   0   0   0 198
 198   0   0   0   0   0 198   0 198   0   0   0   0   0   0   0 198   0 198   0   0   0   0   0 198   0 198   0   0 198   0 198
 198   0 198 198 198 198 198 198 198 198 198 198 198 198 198 198 198   0 198 198 198 198 198 198 198   0 198   0 198 198   0 198
 198   0   0   0   0   0   0   0  95   0   0   0   0   0   0   0 198   0   0   0 198   0   0   0 198   0   0   0   0 198   0 198
 198   0 198 198 198 198 198 198 198 198 198 198 198 198 198   0 198 198 198   0 198   0 198   0 198 198 198 198 198 198   0 198
 198   0   0   0 198   0 198   0   0   0   0   0 198   0   0   0  92   0 198   0  94   0 198   0   0   0   0   0 198  96   0 198
 198 198 198   0 198   0 198   0 198 198 198   0 198   0 198 198 198   0 198 198 198 198 198 198 198 198 198   0 198 198 198 198
 198   0   0   0   0   0 198   0 198   0   0   0   0   0 198   0   0   0   0   0   0   0   0   0   0   0 198   0   0   0   0 198
 198   0 198 198 198 198 198   0 198 198 198 198 198 198 198 198 198 198 198   0 198 198 198 198 198   0 198 198 198 198   0 198
 198   0 198   0   0   0   0   0 198   0   0   0   0   0   0   0   0   0 198 103 198   0   0   0 198   0   0   0 198   0   0 198
 198   0 198   0 198 198 198 198 198   0 198 198 198 198 198 198 198   0 198 198 198   0 198   0 198 198 198   0 198   0 198 198
 198   0 198   0   0   0 198   0   0  98 198   0   0   0   0   0 198   0   0   0 198   0 198   0 198   0   0   0 198   0 102 198
 198   0 198 198 198   0 198   0 198 198 198   0 198 198 198   0 198 198 198   0 198   0 198   0 198 198 198 198 198 198   0 198
 198   0   0  99 198   0   0   0   0   0   0   0 198 100   0   0   0   0 198   0   0 101 198   0   0   0   0   0   0   0   0 198
 198 198 198 198 198 198 198 198 198 198 198 198 198 198 198 198 198 199 198 198 198 198 198 198 198 198 198 198 198 198 198 198
