 198 198 198 198 198 198 198 198 198 198 198 198 198 198 198 198 198 198 198 198 198 198 198 198 198 198 198 198 198 198 198 198
 198   0   0   0   0   0   0   0   0   0   0   0 198   0   0   0   0   0   0   0   0   0 198   0 105   0 198   0   0   0   0 198
 198   0 198 198 198 198 198 198 198   0 198 198 198   0 198 198 198 198 198   0 198   0 198   0 198   0 198   0 198 198   0 198
 198   0   0   0 104   0   0   0 198   0   0   0   0   0   0  87 198   0   0   0 198   0   0   0 198   0   0   0 198   0   0 198
 198 198 198 198 198 198 198   0 198 198 198 198 198 198 198 198 198   0 198 198 198 198 198 198 198 198 198 198 198   0 198 198
 198   0   0   0   0   0   0   0 198   0   0   0   0   0   0  88   0   0 198   0   0   0   0   0 198   0   0   0 198   0   0 198
 198   0 198   0 198 198 198 198 198   0 198 198 198 198 198 198 198 198 198   0 198   0 198   0 107   0 198   0 198 198   0 198
 198   0 198   0   0   0 198   0   0   0 198 106 198   0   0   0   0   0   0   0 198   0 198 198 198 198 198   0   0 198   0 198
 198   0 198 198 198   0 198   0 198   0 198   0   0   0 198   0 198 198 198   0 198   0   0   0 198   0   0   0 198 198   0 198
 198   0 198   0   0   0 198   0 198 198 198 198 198 198 198   0 198 109 198   0 198   0 198   0 198 198 198   0 198   0   0 198
 198 198 198   0 198 198 198   0 198   0   0   0   0   0 198   0 198   0 198   0 198   0 198   0   0   0 198   0 198   0 198 198
 198 116 198   0 198   0   0   0 198   0 198 198 198   0 198   0 198   0 198   0 198 198 198 198 198   0 198   0 198   0 108 198
 198   0 198   0 198   0 198   0   0   0   0 115 198   0 198   0 198   0 198   0 198   0   0   0   0   0 198   0 198 198   0 198
 198   0 198   0 198 198 198 198 198 198 198 198 198   0 198 198 198   0 198   0 198   0 198 198 198   0 198   0 198   0   0 198
 198   0 198 117 198   0   0   0 198   0   0   0 198   0   0 112   0   0 198   0 198   0 198 110   0   0 198 111 198   0 198 198
 198   0 198 198 198   0 198   0 198   0 198   0 198 198 198 198 198 198 198   0 198   0 198 198 198 198 198 198 198   0   0 198
 198   0   0   0   0   0 198   0 118   0 198   0   0   0   0 113   0   0   0   0 198   0   0   0   0   0   0   0   0   0 114 198
 198 198 198 198 198 198 198 198 198 198 198 198 198 198 198 198 198 199 198 198 198 198 198 198 198 198 198 198 198 198 198 198
