 198 198 198 198 198 198 198 198 198 198 198 198 198 198 198 198 198 200 198 198 198 198 198 198 198 198 198 198 198 198 198 198
 198  71 198   0   0   0   0   0   0   0   0   0   0   0   0   0   0   0 198   0   0  66 198   0   0   0   0   0   0   0  61 198
 198   0 198 198 198 198 198   0 198   0 198 198 198 198 198   0 198   0 198   0 198   0 198   0 198 198 198 198 198   0 198 198
 198   0   0   0 198  70 198   0 198  69 198   0 198   0   0   0 198  67 198   0 198   0   0   0 198   0   0   0   0   0   0 198
 198   0 198   0 198   0 198   0 198 198 198   0 198   0 198 198 198 198 198   0 198 198 198 198 198   0 198 198 198 198 198 198
 198   0 198   0 198   0   0   0 198   0   0   0 198   0   0   0   0   0   0   0 198   0   0   0 198   0   0   0   0   0   0 198
 198 198 198   0 198 198 198 198 198   0 198 198 198 198 198 198 198 198 198   0 198   0 198 198 198 198 198 198 198 198   0 198
 198   0   0   0 198   0   0   0 198   0 198   0   0   0 198   0  65   0 198   0   0   0 198   0   0   0   0   0   0   0   0 198
 198   0 198 198 198 198 198 198 198   0 198 198 198   0 198   0 198   0 198 198 198 198 198   0 198 198   0 198 198 198 198 198
 198   0 198   0   0   0   0   0   0  68 198   0   0   0 198   0 198   0   0   0  63   0   0   0 198  64   0 198   0   0   0 198
 198   0 198   0 198 198 198 198 198 198 198   0 198 198 198   0 198   0 198 198 198 198 198   0 198 198 198 198  62 198 198 198
 198   0   0   0 198   0   0   0   0   0   0   0 198   0   0   0 198   0 198   0   0   0 198   0 198   0   0   0   0   0   0 198
 198   0 198 198 198 198 198 198 198 198 198   0 198   0 198 198 198 198 198   0 198   0 198 198 198 198 198   0 198 198 198 198
 198   0   0   0   0   0   0   0 198   0   0   0 198   0   0   0   0   0   0   0 198   0   0   0 198   0   0   0   0   0   0 198
 198 198 198 198 198 198 198   0 198   0 198   0 198   0 198   0 198   0 198   0 198 198 198  57 198 198 198 198 198 198   0 198
 198  60 198   0   0   0 198   0 198   0 198   0 198 198 198   0 198   0 198 198 198   0 198 198 198   0   0   0   0 198   0 198
 198   0   0   0 198   0   0  59   0   0 198   0   0   0   0   0 198   0   0   0   0   0   0   0   0   0 198 198   0   0  58 198
 198 198 198 198 198 198 198 198 198 198 198 198 198 198 198 198 198 199 198 198 198 198 198 198 198 198 198 198 198 198 198 198
