 198 198 198 198 198 198 198 198 198 198 198 198 198 198 198 198 198 200 198 198 198 198 198 198 198 198 198 198 198 198 198 198
 198   0   0   0   0   0   0   0   0   0   0   0   0   0 198   0 198   0   0 198   0 198   0 198 198   0   0 198   0   0   0 198
 198   0 198   0 198 198 198 198 198 198 198 198 198   0 198   0   0   0   0 198   0 198   0   0   0 198 198 198   0 198   0 198
 198   0 198   0 198   0   0   0   0   0   0   0   0   0 198   0 198   0 198 198 198   0   0 198 198 198   0   0   0 198   0 198
 198   0 198   0 198 198 198   0 198 198 198 198 198 198 198   0 198   0   0   0 198 198   0 198   0   0   0   0   0 198   0 198
 198   0 198   0   0   0 198   0 198   0   0   0   0   0   0   0 198   0 198   0   0 198 198 198   0 198 198 198 198 198   0 198
 198   0 198 198 198   0 198 198 198   0 198 198 198 198 198 198 198 198 198 198   0   0   0 198   0 198   0   0   0   0   0 198
 198   0   0   0 198   0   0   0   0   0 198   0   0   0   0   0   0   0   0 198 198 198   0 198   0 198   0 198 198 198 198 198
 198 198 198   0 198 198 198 198 198 198 198   0 198   0 198   0 198 198 198   0 198   0   0 198   0 198   0   0   0 198   0 198
 198   0 198   0 198   0   0   0   0   0 198   0 198 198 198   0   0   0 198   0 198 198   0 198   0 198 198 198   0 198   0 198
 198   0 198   0 198   0 198 198 198   0 198   0   0   0 198 198 198   0 198   0 198   0   0 198   0   0   0 198   0   0   0 198
 198   0   0   0 198   0   0   0 198   0 198   0 198 198 198   0 198   0 198 198 198   0 198 198 198 198   0 198 198 198 198 198
 198   0 198 198 198 198 198   0 198   0 198   0   0   0   0   0 198   0   0   0 198   0   0   0   0   0   0 198   0   0   0 198
 198   0 198   0   0   0 198   0 198   0 198   0 198 198 198 198 198 198 198   0 198 198 198 198 198 198 198 198 198 198   0 198
 198   0   0   0 198   0   0   0 198   0 198   0   0   0   0   0   0   0 198   0   0   0   0   0   0   0   0   0   0   0   0 198
 198 198 198 198 198 198 198 198 198   0 198   0 198 198 198 198 198   0 198 198 198 198 198 198 198 198   0 198 198 198   0 198
 198   0   0   0   0   0   0   0   0   0   0   0 198   0   0   0   0   0   0   0   0   0   0   0   0   0   0   0   0   0   0 198
 198 198 198 198 198 198 198 198 198 198 198 198 198 198 198 198 198 199 198 198 198 198 198 198 198 198 198 198 198 198 198 198
