 198 198 198 198 198 198 198 198 198 198 198 198 198 198 198 198 198 200 198 198 198 198 198 198 198 198 198 198 198 198 198 198
 198   0   0   0   0   0 198   0   3   0   0   0   0   0 198   0   0   0 198   4   0   0   0   0   0   0   0   0 198   0  12 198
 198 198 198   0 198   0 198 198 198 198 198 198 198   0 198 198 198   0 198 198 198 198 198 198 198 198 198   0 198 198   0 198
 198   0   0   0 198   0   0   0   0   0   0   0   0   0 198   0 198   0 198   0   0   0 198   0   0  19 198   0 198   0   0 198
 198   0 198 198 198 198 198   0 198 198 198 198 198 198 198   0 198   0 198   0 198 198 198   0 198 198 198   0 198   0 198 198
 198   0   0   0   0   0 198   0 198   0   0   0   0   0   0   0 198   0   0   0   0   0 198   0   0   0 198   0 198   0   0 198
 198   0 198 198 198   0 198   0 198   0 198 198 198 198 198   0 198 198 198 198 198   0 198 198 198   0 198   0 198 198   0 198
 198   0   0  11 198   0 198   0 198   0   0   0   0   0 198   0   0   0   0   0 198   0 198   0 198   0 198   0 198   0   0 198
 198 198 198 198 198   0 198   0 198 198 198 198 198   0 198 198 198 198 198   0 198   0 198   0 198   0 198   0 198   0 198 198
 198   0   0   0   0   0 198   0   0   0   0   0   0   0 198  38   0   0 198   0 198   0 198   0 198   0 198   0 198   0   0 198
 198 198 198   0 198 198 198   0 198 198 198 198 198 198 198 198 198   0 198   0   0   0 198   0 198   0   0   0   0   0   0 198
 198   0 198   0 198   0 198   0 198   0   0   0   0   0   0   0   0   0 198 198 198 198 198   0 198 198 198   0 198 198 198 198
 198   0   0   0   0   0 198   0 198   0 198 198 198 198 198 198 198   0   0   0 198   0   0   0   0   0   0   0   0   0   0 198
 198   0 198 198 198 198 198   0 198   0 198   0   0   0   0   0 198 198 198   0 198  56 198 198 198 198 198   0 198 198 198 198
 198   0 198   0   0   0   0   0 198   0 198   0 198 198 198   0   0   0 198   0 198 198 198   0   0   0 198   0   0   0   0 198
 198   0 198 198 198 198 198 198 198 198 198   0 198   0 198 198 198   0 198   0 198   0 198   0 198   0 198   0 198 198 198 198
 198   0   0   0   0   0   0   0   0   0   0   0   0   0   0   0   0   0   0   0   0   0   0   0 198   0   0   0  37 198   0 198
 198 198 198 198 198 198 198 198 198 198 198 198 198 198 198 198 198 199 198 198 198 198 198 198 198 198 198 198 198 198 198 198
