 198 198 198 198 198 198 198 198 198 198 198 198 198 198 198 198 198 200 198 198 198 198 198 198 198 198 198 198 198 198 198 198
 198   0   0   0   0   0   0   0   0   0   0   0 198   0   0   0   0   0   0   0  77 198   0 198   0   0   0   0   0 198 198 198
 198   0 198 198 198 198   0 198 198 198 198  74 198   0 198 198 198   0 198 198 198 198   0 198   0 198 198 198   0   0   0 198
 198   0 198   0   0 198   0   0   0   0 198 198 198   0 198   0 198   0   0   0   0   0   0 198   0 198   0 198 198 198   0 198
 198   0 198 198   0 198 198 198 198   0 198   0   0   0   0   0 198 198 198   0 198 198   0 198   0 198   0 198  80   0   0 198
 198   0   0   0   0   0 198   0 198   0 198   0 198 198 198 198 198  73 198   0 198   0   0 198   0 198   0 198   0 198   0 198
 198 198 198   0 198   0   0   0 198   0   0   0 198   0   0   0   0   0 198   0 198   0 198 198   0 198   0   0   0 198   0 198
 198   0 198   0 198 198 198 198 198 198 198 198 198   0 198   0 198 198 198   0 198   0   0   0   0 198   0 198 198 198   0 198
 198   0   0   0 198  72   0   0   0   0   0   0   0   0 198   0 198   0   0   0 198   0 198   0   0 198   0 198   0   0   0 198
 198   0 198 198 198 198 198 198 198 198 198 198 198 198 198   0 198   0 198   0 198   0 198 198 198 198   0 198   0 198   0 198
 198   0   0   0   0   0   0   0   0   0   0   0 198   0   0   0 198   0 198   0 198  76 198   0   0   0   0 198   0 198   0 198
 198 198 198 198 198 198 198 198 198 198 198   0 198   0 198 198 198   0 198 198 198 198 198   0 198 198 198 198   0 198   0 198
 198   0   0   0   0   0 198   0   0   0 198   0 198   0   0   0 198   0 198   0   0   0 198   0   0 198   0 198   0   0   0 198
 198   0 198 198 198   0 198   0 198   0 198   0 198 198 198   0 198   0 198   0 198   0 198 198   0 198   0 198 198 198   0 198
 198   0 198   0   0   0 198   0 198   0   0   0 198   0   0   0 198   0   0   0 198   0   0 198   0 198   0 198   0   0   0 198
 198   0 198   0 198 198 198   0 198 198 198 198 198   0 198   0 198 198 198 198 198 198 198 198   0 198 198 198   0 198 198 198
 198  75 198   0   0   0   0   0   0   0   0   0   0   0 198   0   0   0   0   0   0   0  78 198   0   0   0   0   0   0  79 198
 198 198 198 198 198 198 198 198 198 198 198 198 198 198 198 198 198 199 198 198 198 198 198 198 198 198 198 198 198 198 198 198
