 198 198 198 198 198 198 198 198 198 198 198 198 198 198 198 198 198 200 198 198 198 198 198 198 198 198 198 198 198 198 198 198
 198   0   0   0   0   0   0   0   0   0   0   0   0   0 198   0 198   0   0 198   0 198   0 198 198   0   0 198   0   0   0 198
 198   0 198   0 198 198 198 198 198 198 198 198 198   0 198   0   0   0   0 198   0 198   0   0   0 198 198 198   0 198   0 198
 198   0 198   0 198   0   0   0   0   0   0   0   0   0 198   0 198   0 198 198 198   0   0 198 198 198   0   0   0 198   0 198
 198   0 198   0 198 198 198   0 198 198 198 198 198 198 198   0 198   0   0   0 198 198   0 198   0   0   0   0   0 198   0 198
 198   0 198   0   0   0 198  43 198   0   0   0   0   0   0   0 198   0 198   0   0 198 198 198   0 198 198 198 198 198   0 198
 198   0 198 198 198   0 198 198 198   0 198 198 198 198 198 198 198 198 198 198   0   0   0 198   0 198   0   0   0   0   0 198
 198   0   0   0 198   0   0   0   0   0 198   0   0   0   0   0   0   0   0 198 198 198   0 198   0 198   0 198 198 198 198 198
 198 198 198   0 198 198 198 198 198 198 198   0 198   0 198   0 198 198 198   0 198  42   0 198   0 198   0   0   0 198  46 198
 198   0 198   0 198   0   0   0   0   0 198   0 198 198 198   0   0   0 198   0 198 198   0 198   0 198 198 198   0 198   0 198
 198   0 198   0 198   0 198 198 198   0 198   0   0  41 198 198 198   0 198   0 198   0   0 198   0   0   0 198   0   0   0 198
 198   0   0   0 198   0   0   0 198   0 198   0 198 198 198  40 198   0 198 198 198   0 198 198 198 198   0 198 198 198 198 198
 198   0 198 198 198 198 198   0 198   0 198   0   0   0   0   0 198   0   0   0 198   0   0   0   0   0   0 198   0   0   0 198
 198   0 198   0   0   0 198   0 198   0 198   0 198 198 198 198 198 198 198   0 198 198 198 198 198 198 198 198 198 198   0 198
 198   0   0   0 198   0   0   0 198   0 198   0   0   0   0   0   0   0 198   0   0   0   0   0   0   0   0   0   0   0   0 198
 198 198 198 198 198 198 198 198 198   0 198   0 198 198 198 198 198   0 198 198 198 198 198 198 198 198   0 198 198 198   0 198
 198  44   0   0   0   0   0   0   0   0   0   0 198   0   0   0   0   0   0   0   0   0   0   0   0   0   0   0  39   0   0 198
 198 198 198 198 198 198 198 198 198 198 198 198 198 198 198 198 198 199 198 198 198 198 198 198 198 198 198 198 198 198 198 198
